{
	"tiles": [0, 0, 0, 0, 0, 0, 0, 0, 0, 0, 0, 0, 0, 0, 0, 0, 0, 0, 0, 0, 0, 0, 0, 0, 0, 0,
			0, 0, 0, 0, 0, 0, 0, 0, 0, 0, 0, 0, 0, 0, 0, 0, 0, 0, 0, 0, 0, 0, 0, 0, 0, 0,
			0, 0, 0, 0, 0, 0, 0, 0, 0, 0, 0, 0, 0, 0, 0, 0, 0, 0, 0, 0, 0, 0, 0, 0, 0, 0,
			1, 0, 0, 0, 0, 0, 0, 0, 0, 0, 0, 0, 0, 0, 0, 0, 0, 0, 0, 0, 0, 0, 0, 0, 0, 1,
			1, 1, 1, 0, 0, 0, 0, 0, 0, 0, 0, 2, 5, 5, 2, 0, 0, 0, 0, 0, 0, 0, 0, 1, 1, 1,
			1, 1, 1, 1, 1, 1, 0, 0, 0, 0, 0, 2, 5, 5, 2, 0, 0, 0, 0, 0, 1, 1, 1, 1, 1, 1,
			1, 1, 1, 1, 1, 1, 1, 1, 1, 1, 0, 0, 0, 0, 0, 0, 1, 1, 1, 1, 1, 1, 1, 1, 1, 1,
			1, 1, 1, 1, 1, 1, 0, 0, 1, 1, 1, 1, 1, 1, 1, 1, 1, 1, 0, 0, 1, 1, 1, 1, 1, 1,
			1, 1, 1, 1, 1, 0, 3, 3, 0, 1, 1, 1, 1, 1, 1, 1, 1, 0, 3, 3, 0, 1, 1, 1, 1, 1,
			1, 1, 1, 1, 1, 0, 3, 3, 0, 1, 1, 1, 5, 5, 1, 1, 1, 0, 3, 3, 0, 1, 1, 1, 1, 1,
			5, 5, 2, 1, 1, 1, 0, 0, 1, 1, 1, 5, 2, 2, 5, 1, 1, 1, 0, 0, 1, 1, 1, 2, 5, 5,
			5, 5, 2, 2, 1, 1, 1, 1, 1, 1, 5, 5, 2, 2, 5, 5, 1, 1, 1, 1, 1, 1, 2, 2, 5, 5,
			5, 5, 2, 2, 1, 1, 1, 1, 1, 5, 2, 2, 2, 2, 2, 2, 5, 1, 1, 1, 1, 1, 2, 2, 5, 5,
			5, 5, 2, 2, 1, 1, 1, 1, 1, 5, 2, 2, 2, 2, 2, 2, 5, 1, 1, 1, 1, 1, 2, 2, 5, 5,
			5, 5, 2, 2, 1, 1, 1, 1, 1, 1, 5, 5, 2, 2, 5, 5, 1, 1, 1, 1, 1, 1, 2, 2, 5, 5,
			5, 5, 2, 1, 1, 1, 0, 0, 1, 1, 1, 5, 2, 2, 5, 1, 1, 1, 0, 0, 1, 1, 1, 2, 5, 5,
			1, 1, 1, 1, 1, 0, 3, 3, 0, 1, 1, 1, 5, 5, 1, 1, 1, 0, 3, 3, 0, 1, 1, 1, 1, 1,
			1, 1, 1, 1, 1, 0, 3, 3, 0, 1, 1, 1, 1, 1, 1, 1, 1, 0, 3, 3, 0, 1, 1, 1, 1, 1,
			1, 1, 1, 1, 1, 1, 0, 0, 1, 1, 1, 1, 1, 1, 1, 1, 1, 1, 0, 0, 1, 1, 1, 1, 1, 1,
			1, 1, 1, 1, 1, 1, 1, 1, 1, 1, 0, 0, 0, 0, 0, 0, 1, 1, 1, 1, 1, 1, 1, 1, 1, 1,
			1, 1, 1, 1, 1, 1, 0, 0, 0, 0, 0, 2, 5, 5, 2, 0, 0, 0, 0, 0, 1, 1, 1, 1, 1, 1,
			1, 1, 1, 0, 0, 0, 0, 0, 0, 0, 0, 2, 5, 5, 2, 0, 0, 0, 0, 0, 0, 0, 0, 1, 1, 1,
			1, 0, 0, 0, 0, 0, 0, 0, 0, 0, 0, 0, 0, 0, 0, 0, 0, 0, 0, 0, 0, 0, 0, 0, 0, 1,
			0, 0, 0, 0, 0, 0, 0, 0, 0, 0, 0, 0, 0, 0, 0, 0, 0, 0, 0, 0, 0, 0, 0, 0, 0, 0,
			0, 0, 0, 0, 0, 0, 0, 0, 0, 0, 0, 0, 0, 0, 0, 0, 0, 0, 0, 0, 0, 0, 0, 0, 0, 0,
			0, 0, 0, 0, 0, 0, 0, 0, 0, 0, 0, 0, 0, 0, 0, 0, 0, 0, 0, 0, 0, 0, 0, 0, 0, 0],
	"enemies": ["0", "0", "1", "B0", "0", "0", "1", "B0", "0", "0", "1", "B0", "0", "0", "1", "B0", "1", "1", "1", "B1"]
}