{
	"tileIndexes": [-1, -1, -1, -1, -1, -1, -1, -1, -1, -1, -1, -1, -1, -1, -1, -1, -1, -1, -1, -1, -1, -1, -1, -1, -1, -1,
			-1, -1, -1, -1, -1, -1, -1, -1, -1, -1, -1, -1, -1, -1, -1, -1, -1, -1, -1, -1, -1, -1, -1, -1, -1, -1,
			-1, -1, 1, 1, 0, 0, 1, 1, 0, 0, 1, 1, 0, 0, 1, 1, 0, 0, 1, 1, 0, 0, 1, 1, -1, -1,
			-1, -1, 1, 1, 0, 0, 1, 1, 0, 0, 1, 1, 0, 0, 1, 1, 0, 0, 1, 1, 0, 0, 1, 1, -1, -1,
			-1, -1, -1, -1, -1, -1, -1, -1, -1, -1, -1, -1, 4, 4, -1, -1, -1, -1, -1, -1, -1, -1, -1, -1, -1, -1,
			-1, -1, -1, -1, -1, -1, -1, -1, -1, -1, -1, -1, 4, 4, -1, -1, -1, -1, -1, -1, -1, -1, -1, -1, -1, -1,
			0, 0, -1, -1, -1, -1, 0, 0, -1, -1, -1, -1, -1, -1, -1, -1, -1, -1, 0, 0, -1, -1, -1, -1, 0, 0,
			0, 0, -1, -1, -1, -1, 0, 0, -1, -1, -1, -1, -1, -1, -1, -1, -1, -1, 0, 0, -1, -1, -1, -1, 0, 0,
			0, 0, 0, 0, -1, -1, 1, 1, -1, -1, 0, 0, 0, 0, 0, 0, -1, -1, 1, 1, -1, -1, 0, 0, 0, 0,
			0, 0, 0, 0, -1, -1, 1, 1, -1, -1, 0, 0, 0, 0, 0, 0, -1, -1, 1, 1, -1, -1, 0, 0, 0, 0,
			1, 1, 0, 0, -1, -1, 0, 0, -1, -1, 0, 0, 1, 1, 0, 0, -1, -1, 0, 0, -1, -1, 0, 0, 1, 1,
			1, 1, 0, 0, -1, -1, 0, 0, -1, -1, 0, 0, 1, 1, 0, 0, -1, -1, 0, 0, -1, -1, 0, 0, 1, 1,
			0, 0, 0, 0, -1, -1, 1, 1, -1, -1, 0, 0, 0, 0, 0, 0, -1, -1, 1, 1, -1, -1, 0, 0, 0, 0,
			0, 0, 0, 0, -1, -1, 1, 1, -1, -1, 0, 0, 0, 0, 0, 0, -1, -1, 1, 1, -1, -1, 0, 0, 0, 0,
			0, 0, -1, -1, -1, -1, 0, 0, -1, -1, -1, -1, -1, -1, -1, -1, -1, -1, 0, 0, -1, -1, -1, -1, 0, 0,
			0, 0, -1, -1, -1, -1, 0, 0, -1, -1, -1, -1, -1, -1, -1, -1, -1, -1, 0, 0, -1, -1, -1, -1, 0, 0,
			-1, -1, -1, -1, -1, -1, -1, -1, -1, -1, 0, 0, 4, 4, 0, 0, -1, -1, -1, -1, -1, -1, -1, -1, -1, -1,
			-1, -1, -1, -1, -1, -1, -1, -1, -1, -1, 0, 0, 4, 4, 0, 0, -1, -1, -1, -1, -1, -1, -1, -1, -1, -1,
			-1, -1, 0, 0, 0, 0, 0, 0, 0, 0, 0, 0, -1, -1, 0, 0, 0, 0, 0, 0, 0, 0, 0, 0, -1, -1,
			-1, -1, 0, 0, 0, 0, 0, 0, 0, 0, 0, 0, -1, -1, 0, 0, 0, 0, 0, 0, 0, 0, 0, 0, -1, -1,
			-1, -1, -1, -1, 1, 1, -1, -1, -1, -1, -1, -1, -1, -1, -1, -1, -1, -1, -1, -1, 1, 1, -1, -1, -1, -1,
			-1, -1, -1, -1, 1, 1, -1, -1, -1, -1, -1, -1, -1, -1, -1, -1, -1, -1, -1, -1, 1, 1, -1, -1, -1, -1,
			0, 0, -1, -1, -1, -1, -1, -1, -1, -1, -1, -1, -1, -1, -1, -1, -1, -1, -1, -1, -1, -1, -1, -1, 0, 0,
			0, 0, -1, -1, -1, -1, -1, -1, -1, -1, -1, -1, -1, -1, -1, -1, -1, -1, -1, -1, -1, -1, -1, -1, 0, 0,
			0, 0, 0, 0, -1, -1, -1, -1, -1, -1, -1, -1, -1, -1, -1, -1, -1, -1, -1, -1, -1, -1, 0, 0, 0, 0,
			0, 0, 0, 0, -1, -1, -1, -1, -1, -1, -1, -1, -1, -1, -1, -1, -1, -1, -1, -1, -1, -1, 0, 0, 0, 0],
	"enemyTypes": ["0", "0", "0", "B0", "0", "0", "0", "B0", "1", "0", "0", "0", "B0", "0", "0", "0", "B0", "1"]
}