{
	"tileIndexes": [-1, -1, -1, -1, -1, -1, 1, 0, 0, 0, 0, 1, -1, -1, 1, 0, 0, 0, 0, 1, -1, -1, -1, -1, -1, -1,
            -1, -1, -1, -1, -1, -1, -1, -1, 0, 0, -1, -1, -1, -1, -1, -1, 0, 0, -1, -1, -1, -1, -1, -1, -1, -1,
            -1, -1, -1, -1, -1, -1, -1, -1, 0, 0, -1, -1, -1, -1, -1, -1, 0, 0, -1, -1, -1, -1, -1, -1, -1, -1,
            -1, -1, -1, -1, -1, -1, -1, -1, 0, 0, -1, -1, -1, -1, -1, -1, 0, 0, -1, -1, -1, -1, -1, -1, -1, -1,
            0, 0, 0, 1, 3, 3, 1, 0, 0, 0, 0, 1, 3, 3, 1, 0, 0, 0, 0, 1, 3, 3, 1, 0, 0, 0,
            4, 4, 4, 1, 3, 3, 1, 4, 4, 4, 4, 1, 3, 3, 1, 4, 4, 4, 4, 1, 3, 3, 1, 4, 4, 4,
            4, 4, 4, 1, 3, 3, 1, 4, 4, 4, 4, 1, 3, 3, 1, 4, 4, 4, 4, 1, 3, 3, 1, 4, 4, 4,
            4, 4, 0, 1, 3, 3, 1, 0, 0, 0, 0, 1, 3, 3, 1, 0, 0, 0, 0, 1, 3, 3, 1, 0, 4, 4,
            4, 0, 0, 0, -1, -1, 0, 0, 0, 0, 0, 0, -1, -1, 0, 0, 0, 0, 0, 0, -1, -1, 0, 0, 0, 4,
            4, 0, 0, 0, -1, -1, 0, 0, 0, 0, 0, 0, -1, -1, 0, 0, 0, 0, 0, 0, -1, -1, 0, 0, 0, 4,
            4, 0, 0, 0, -1, -1, 0, 0, 0, 0, 0, 0, -1, -1, 0, 0, 0, 0, 0, 0, -1, -1, 0, 0, 0, 4,
            4, 0, 0, -1, -1, -1, -1, 0, 0, 0, 0, -1, -1, -1, -1, 0, 0, 0, 0, -1, -1, -1, -1, 0, 0, 4,
            4, 0, 0, -1, 1, 1, -1, 0, 0, 0, 0, -1, 1, 1, -1, 0, 0, 0, 0, -1, 1, 1, -1, 0, 0, 4,
            4, 0, 0, -1, 1, 1, -1, -1, 0, 0, -1, -1, 1, 1, -1, -1, 0, 0, -1, -1, 1, 1, -1, 0, 0, 4,
            4, 0, 0, -1, -1, -1, -1, -1, -1, -1, -1, -1, -1, -1, -1, -1, -1, -1, -1, -1, -1, -1, -1, 0, 0, 4,
            4, 0, 0, 0, 0, 0, 0, -1, -1, -1, -1, 0, 0, 0, 0, -1, -1, -1, -1, 0, 0, 0, 0, 0, 0, 4,
            4, 0, 0, 0, 0, 0, 0, 0, -1, -1, 0, 0, 0, 0, 0, 0, -1, -1, 0, 0, 0, 0, 0, 0, 0, 4,
            4, 0, 0, 0, 0, 0, 0, 0, -1, -1, 0, 0, 0, 0, 0, 0, -1, -1, 0, 0, 0, 0, 0, 0, 0, 4,
            4, 4, 0, 0, 0, 0, 0, 1, 3, 3, 1, 0, 0, 0, 0, 1, 3, 3, 1, 0, 0, 0, 0, 0, 4, 4,
            4, 4, 4, 4, 4, 4, 4, 1, 3, 3, 1, 4, 4, 4, 4, 1, 3, 3, 1, 4, 4, 4, 4, 4, 4, 4,
            4, 4, 4, 4, 4, 4, 4, 1, 3, 3, 1, 4, 4, 4, 4, 1, 3, 3, 1, 4, 4, 4, 4, 4, 4, 4,
            0, 0, 0, 0, 0, 0, 0, 1, 3, 3, 1, 0, 0, 0, 0, 1, 3, 3, 1, 0, 0, 0, 0, 0, 0, 0,
            -1, 0, 0, -1, 0, 0, -1, -1, -1, -1, -1, -1, -1, -1, -1, -1, -1, -1, -1, -1, 0, 0, -1, 0, 0, -1,
            -1, 0, 0, -1, 0, 0, -1, -1, -1, -1, -1, -1, -1, -1, -1, -1, -1, -1, -1, -1, 0, 0, -1, 0, 0, -1,
            -1, 0, 0, -1, 0, 0, -1, -1, -1, -1, -1, -1, -1, -1, -1, -1, -1, -1, -1, -1, 0, 0, -1, 0, 0, -1,
            0, 0, 0, 0, 0, 0, 0, 1, -1, -1, 1, -1, -1, -1, -1, 1, -1, -1, 1, 0, 0, 0, 0, 0, 0, 0],
	"enemyTypes": ["1", "1", "1", "1", "1", "1", "1", "1", "B1", "1", "1", "1", "1", "1", "1", "1", "1", "B1", "2", "2", "2", "2", "2", "2", "2", "3", "B2"]
}