{
	"tiles": [-1, -1, -1, -1, -1, -1, -1, -1, -1, -1, -1, -1, -1, -1, -1, -1, -1, -1, -1, -1, -1, -1, -1, -1, -1, -1,
			-1, -1, -1, -1, -1, -1, -1, -1, -1, -1, -1, -1, -1, -1, -1, -1, -1, -1, -1, -1, -1, -1, -1, -1, -1, -1,
			-1, -1, -1, -1, -1, -1, -1, -1, -1, -1, -1, -1, -1, -1, -1, -1, -1, -1, -1, -1, -1, -1, -1, -1, -1, -1,
			0, -1, -1, -1, -1, -1, -1, -1, -1, -1, -1, -1, -1, -1, -1, -1, -1, -1, -1, -1, -1, -1, -1, -1, -1, 0,
			0, 0, 0, -1, -1, -1, -1, -1, -1, -1, -1, 1, 4, 4, 1, -1, -1, -1, -1, -1, -1, -1, -1, 0, 0, 0,
			0, 0, 0, 0, 0, 0, -1, -1, -1, -1, -1, 1, 4, 4, 1, -1, -1, -1, -1, -1, 0, 0, 0, 0, 0, 0,
			0, 0, 0, 0, 0, 0, 0, 0, 0, 0, -1, -1, -1, -1, -1, -1, 0, 0, 0, 0, 0, 0, 0, 0, 0, 0,
			0, 0, 0, 0, 0, 0, -1, -1, 0, 0, 0, 0, 0, 0, 0, 0, 0, 0, -1, -1, 0, 0, 0, 0, 0, 0,
			0, 0, 0, 0, 0, -1, 2, 2, -1, 0, 0, 0, 0, 0, 0, 0, 0, -1, 2, 2, -1, 0, 0, 0, 0, 0,
			0, 0, 0, 0, 0, -1, 2, 2, -1, 0, 0, 0, 4, 4, 0, 0, 0, -1, 2, 2, -1, 0, 0, 0, 0, 0,
			4, 4, 1, 0, 0, 0, -1, -1, 0, 0, 0, 4, 1, 1, 4, 0, 0, 0, -1, -1, 0, 0, 0, 1, 4, 4,
			4, 4, 1, 1, 0, 0, 0, 0, 0, 0, 4, 4, 1, 1, 4, 4, 0, 0, 0, 0, 0, 0, 1, 1, 4, 4,
			4, 4, 1, 1, 0, 0, 0, 0, 0, 4, 1, 1, 1, 1, 1, 1, 4, 0, 0, 0, 0, 0, 1, 1, 4, 4,
			4, 4, 1, 1, 0, 0, 0, 0, 0, 4, 1, 1, 1, 1, 1, 1, 4, 0, 0, 0, 0, 0, 1, 1, 4, 4,
			4, 4, 1, 1, 0, 0, 0, 0, 0, 0, 4, 4, 1, 1, 4, 4, 0, 0, 0, 0, 0, 0, 1, 1, 4, 4,
			4, 4, 1, 0, 0, 0, -1, -1, 0, 0, 0, 4, 1, 1, 4, 0, 0, 0, -1, -1, 0, 0, 0, 1, 4, 4,
			0, 0, 0, 0, 0, -1, 2, 2, -1, 0, 0, 0, 4, 4, 0, 0, 0, -1, 2, 2, -1, 0, 0, 0, 0, 0,
			0, 0, 0, 0, 0, -1, 2, 2, -1, 0, 0, 0, 0, 0, 0, 0, 0, -1, 2, 2, -1, 0, 0, 0, 0, 0,
			0, 0, 0, 0, 0, 0, -1, -1, 0, 0, 0, 0, 0, 0, 0, 0, 0, 0, -1, -1, 0, 0, 0, 0, 0, 0,
			0, 0, 0, 0, 0, 0, 0, 0, 0, 0, -1, -1, -1, -1, -1, -1, 0, 0, 0, 0, 0, 0, 0, 0, 0, 0,
			0, 0, 0, 0, 0, 0, -1, -1, -1, -1, -1, 1, 4, 4, 1, -1, -1, -1, -1, -1, 0, 0, 0, 0, 0, 0,
			0, 0, 0, -1, -1, -1, -1, -1, -1, -1, -1, 1, 4, 4, 1, -1, -1, -1, -1, -1, -1, -1, -1, 0, 0, 0,
			0, -1, -1, -1, -1, -1, -1, -1, -1, -1, -1, -1, -1, -1, -1, -1, -1, -1, -1, -1, -1, -1, -1, -1, -1, 0,
			-1, -1, -1, -1, -1, -1, -1, -1, -1, -1, -1, -1, -1, -1, -1, -1, -1, -1, -1, -1, -1, -1, -1, -1, -1, -1,
			-1, -1, -1, -1, -1, -1, -1, -1, -1, -1, -1, -1, -1, -1, -1, -1, -1, -1, -1, -1, -1, -1, -1, -1, -1, -1,
			-1, -1, -1, -1, -1, -1, -1, -1, -1, -1, -1, -1, -1, -1, -1, -1, -1, -1, -1, -1, -1, -1, -1, -1, -1, -1],
	"enemies": ["0", "0", "1", "B0", "0", "0", "1", "B0", "0", "0", "1", "B0", "0", "0", "1", "B0", "1", "1", "1", "B1"]
}